also remove image=eliminar también la imagen
Apply=Aplicar
Are you sure=¿Estás seguro?
Cancel=Cancelar
checking=comprobando
Completely REMOVE=Eliminar COMPLETAMENTE
Console=Terminal
day=día
days=días
disk image and definition=imagen de disco y archivo de configuración
Disks=Discos
Donate=Donación
Done=Hecho
Edit=Editar
Execution error=Error de ejecución
Force Stop=Forzar parada
Hibernate=Hibernar
Log for=Registro de
log=registro
Logs=Registros
More Info=Más información
No=No
OK=OK
Ok=Ok
Pause=Suspender
Proceed=Seguir
Project Page=Página del proyecto
Read Me First=Leer primero
Remove container=Eliminar contenedor
Remove definition=Eliminar definición:
Remove image=Eliminar imagen
Remove VM=Eliminar VM
Remove=Eliminar
Restart=Reiniciar
Resume=Reanudar
Start=Iniciar
Stop=Detener
Support=Soporte
Update container=Actualizar contenedor
Update=Actualizar
Updating all Containers=Actualizando todos los Contenedores
Updating the container=Actualizando el contenedor
VNC Remote=VNC Remoto
WebUI=Interfaz Web
Yes, delete it=Sí, eliminar
Yes, update it=Sí, actualizar
Yes=Sí

; footer messages
Array Copying=Copiando Array
Array Clearing=Limpiando Array
Array Starting=Iniciando Array
Array Stopping=Deteniendo Array
Mounting disks=Montando discos
Retry unmounting user shares=Reintentar desmontar la(s) carpeta(s) compartida(s) del usuario
Spinning up all drives=Activando todos los discos
Stale configuration=Configuración antigua
Starting services=Iniciando servicios
Stopping services=Deteniendo servicios
Starting Recycle Bin=Iniciar la papelera de reciclaje
Stopping Recycle Bin=Detener la papelera de reciclaje
Sync filesystems=Sincronizar sistemas de archivos
Unmounting disks=Desmontando discos
Autostart disabled=Inicio automático deshabilitado
Missing encryption key=Falta la clave de cifrado
Opening encrypted volumes=Abriendo volúmenes cifrados

; docker variables
Container Path=Ruta del contenedor
Container Port=Puerto del contenedor
Container Variable=Varible del contenedor
Container Label=Etiqueta del contenedor
Container Device=Dispositivo del contenedor
