%s An update is available=%s tiene una actualización disponible
Alert Message=Mensaje de alerta
anonymous=anónimo
Author=Autor
cannot check=no se puede comprobar
Check For Updates=Buscar actualizaciones
Checking connectivity=Comprobando la conectividad
checking=comprobando
Click here to install version %s=Haga clic aquí para instalar la versión %s
Delete Plugin=Eliminar Plugin
DOWNGRADE TO VERSION=VOLVER A LA VERSIÓN ANTERIOR
Enter URL of remote plugin file or local plugin file=Introduzca la URL remota del Plugin o la ruta local del Plugin
ERROR=ERROR
I have read the release notes=He leído las notas de la versión
Install Plugin=Instalar Plugin
Install=Instalar
install=instalar
Installed Plugins=Plugins Instalados
Installing Update=Instalando actualización
need check=necesita revisión
Next=Siguiente
No plugins installed=No hay plugins instalados
No release notes available=No hay notas de la versión disponibles
No response, aborting=Sin respuesta, cancelando
Plugin File Install Errors=Errores de instalación de los archivos del plugin
Plugin File=Archivo del Plugin
Plugin History=Historial de plugin
Plugin Update Check=Buscar Actualizaciones de Plugin
Plugin=Plugin
Release Notes=Notas de la versión
Remove Plugin=Eliminar Plugin
Remove Selected Plugins=Eliminar complementos seleccionados
remove=eliminar
Select local plugin file=Seleccione el archivo local del Plugin
Stable=Estable
STALE=OBSOLETO
Support Thread=Sitio de soporte
Uninstall=Desinstalar
Update All Plugins=Actualizar todos los Plugins
Update Incompatible=Actualización incompatible
Update Plugin=Actualizar Plugin
Upgrade=Actualizar
View Release Notes=Ver notas de la versión
