%s ago=
%s is out of range minimum 1 maximum 65535=%s is out of range (minimum 1 maximum 65535)
12 hours=12 horas
24 hours=24 horas
8023ad=8023ad
Accumulation duration=
Accumulation frequency=
Activate=Activar
Activated=Activado
Activating=Activando
Active Directory Settings=Ajustes de Active Directory
Active Directory=Active Directory
active-backup=backup-activo
AD account login=Cuenta de usuario de AD
AD account password=Contraseña de AD
AD domain name=Nombre de dominio de AD
AD initial group=Grupo inicial de AD
AD initial owner=Propietario inicial de AD
AD join status=Estado de la unión a AD
AD short domain name=Nombre corto de dominio de AD
Add Peer=
Add Route=Agregar Ruta
Add Tunnel=
Add VLAN=Agregar VLAN
Advanced=
Agent function=Funciones del servicio
Agents=Servicios
Alerts=Alertas
Allow Remote Access=Permitir acceso remoto
Allow=
and, the first and last characters must be alphanumeric=y, el primer y último caracteres deben ser alfanuméricos
and=y
APC UPS Daemon user manual=Manual de usuario del servicio del SAI APC
APCsmart=APCsmart
Apply to activate Docker after Array is Started=
Apply to activate VMs after Array is Started=Aplicar para activar el servicio de VMs tras iniciar el Array
Applying=
Array must be Stopped to change=El array debe estar **Detenido** para realizar cambios
Array status notification=Notificación de estado del Array
Array status=Estado del Array
Assignment error=Error de asignación
Attention=Atención
Attribute=Atributo
Authentication method=Método de autenticación
automatic=
Autostart=
Available notifications=Notificaciones disponibles
Balance schedule=
balance-alb=balance-alb
balance-rr=balance-rr
balance-tlb=balance-tlb
balance-xor=balance-xor
Bar color - Text=Barra (color) - Texto
Bar color=Barra (color)
Bar gray - Text=Barra (gris) - Texto
Bar gray=Barra (gris)
Basic=
Battery Charge=Nivel de Batería
Battery level to initiate shutdown=Nivel de batería para iniciar apagado
bfq=bfq
Block group usage=
Bonding members of=Miembros de la unión de interfaces
Bonding mode=Modo de unión de interfaces
Both=Ambos
bottom-left=inferior-izquierda
bottom-right=inferior-derecha
Bridging members of=Miembros del puente de red
broadcast=broadcast
Browser=Navegador
btrfs filesystem show=Información del sistema de archivos btrfs
btrfs scrub status=Estado de depuración btrfs
btrfs vDisk=
Cache disk not enabled=Disco caché no habilitado
Cache Settings=Ajustes del Caché
Cannot provision cert that would overwrite your existing custom cert at=No se puede proveer un certificado que pueda sobrescribir su certificado personalizado
Cannot renew cert until within 30 days of expiry=No se puede renovar el certificado hasta que falten menos de 30 días para que caduque
Cannot renew a custom cert at=
CA-signed certificate file=
Celsius=
center=centro
Certificate expiration=Caducidad del certificado
Certificate issuer=Emisor del certificado
Certificate subject=
Certificate will not renew unless you are signed in to Unraidnet=Certificate will not renew unless you are signed in to Unraid.net
Changes=Cambios
Check cable=Compruebe el cable
Check four times a day=Comprobar cuatro veces al día
Check once a day=Comprobar una vez al día
Check once a month=Comprobar una vez al mes
Check once a week=Comprobar una vez a la semana
Check twice a day=Comprobar dos veces al día
Checking=
CIDR optional=
Click here to see the Unraid Wiki for more information=Haga clic aquí para ver más información en la Wiki de Unraid
Click to invoke the Mover=Haga clic aquí para invocar al Mover
Click to select PNG file=Haga clic aquí para seleccionar un archivo PNG
Click to Select=Haga clic aquí para seleccionar
Comma separated list of IPv4 and IPv6 IP addresses=
configure your router with a static route of=
configure your router with port forwarding of port=
configuring interface=configurando interfaz
Confirm array stop command=Confirmar comando de detención del array
Confirm reboot powerdown commands=Confirmar comandos de reinicio y apagado del array
Confirm sleep command=Confirmar comando de suspensión del array
Confirmations=Confirmaciones
connect to any device on the VPN tunnel=
connect to this server using IP address=
Container=Contenedor
Content=Contenido
Correct file system errors=Corregir errores del sistema de archivos
CPU Isolation A reboot is required to apply changes=CPU Isolation: A reboot is required to apply changes
CPU isolation is prohibited while system is running in SAFE MODE=El aislamiento de CPU no está permitido mientras el sistema está en MODO SEGURO
CPU Isolation=Aislamiento de CPU
CPU Pinning Docker=Asignación de CPU para Docker
CPU Pinning VM=Asignación de CPU para VM
CPU Pinning=Asignación de CPU
CRAM-MD5=
Cumulative parity check=
Current date and time=Fecha y hora actual
Current usage ratio=
Custom attributes use comma to separate numbers=Atributos personalizados (use comas para separar los números)
Custom banner=Banner personalizado
Custom UPS cable=Cable de SAI personalizado
Custom=Personalizado
custom=personalizado
D comma G dot=[D] coma : [M] punto
D comma G none=[D] coma : [M] nada
D comma G space=[D] coma : [M] espacio
D dot G comma=[D] punto : [M] coma
D dot G none=[D] punto : [M] nada
D dot G space=[D] punto : [M] espacio
Daily=Diaria
Data received=
Data sent=
Date and Time=Fecha y Hora
Date format=Formato de fecha
Day of the month=Día del mes
Day of the week=Día de la semana
Day, D Month YYYY=Día, D Mes AAAA
Day, DD.MM.YYYY=
Day, DD-MM-YYYY=Día, DD-MM-AAAA
Day, MMDDYYYY=Día, MM/DD/AAAA
Day, Month D, YYYY=Día, Mes D, AAAA
Day, YYYY Month D=Día, AAAA Mes D
Day, YYYY-MM-DD=Día, AAAA-MM-DD
DD-MM-YYYY=DD-MM-AAAA
Deactivate=Desactivar
Deactivating=Desactivando
Default appdata storage location=Ruta de appdata por defecto
Default critical disk temperature threshold=Umbral de temperatura crítica de disco por defecto
Default critical disk utilization threshold=Umbral de uso crítico de disco por defecto
Default file system=Sistema de archivos por defecto
Default ISO storage path=Ruta por defecto para imágenes ISO
Default network bridge=Puente de red por defecto
Default partition format=Formato de partición por defecto
Default SMART attribute notifications=Notificaciones de atributos SMART por defecto
Default SMART controller type=Tipo de controlador SMART por defecto
Default SMART notification tolerance level=Nivel de tolerancia por defecto para notificación SMART
Default SMART notification value=Valor SMART por defecto para notificación
Default spin down delay=Retardo por defecto para poner discos en reposo
Default VM storage path=Ruta por defecto para máquinas virtuales
Default warning disk temperature threshold=Umbral de temperatura de disco por defecto para advertencia
Default warning disk utilization threshold=Umbral de uso de disco por defecto para advertencia
Default Windows VirtIO driver ISO=ISO de controladores VirtIO para Windows por defecto
Define a TLS certificate=Defina un certificado TLS
Delete directory=
Delete Image File=Eliminar Archivo de Imagen
Delete Peer=
Delete Tunnel=
Delete tunnel failed=
Delete vDisk file=
Delete VLAN=Eliminar VLAN
Deny=
Desired MTU=MTU deseado
Detailed=Detallado
Device=Dispositivo
DHCP pool=Espacio DHCP
directory=
Disk Settings=Ajustes de Disco
Display array totals=Mostrar estadísticas totales del array
Display device name=Mostrar nombre de dispositivo
Display position=Mostrar posición
Display Settings=Ajustes de Pantalla
Display world-wide-name in device ID=Mostrar el World Wide Name en el ID de dispositivo
DNS Propagation is PENDING=
DNS Rebinding Protection is ENABLED=
DNS servers=
docker containers on custom networks need static routing=
Docker custom network type=
Docker data-root=
Docker directory=
Docker LOG maximum file size=Tamaño máximo del registro de Docker
Docker LOG number of files=Número de archivos del registro de Docker
Docker LOG rotation=Rotación del registro de Docker
Docker only=Solo Docker
Docker service=Servicio Docker
Docker Stop Timeout=
Docker update notification=Notificación de actualización de Dockers
Docker update=Actualización de Dockers
Docker vDisk location=Ruta del vDisk de Docker
Docker vDisk size=Tamaño del vDisk de Docker
Docker version=Versión de Docker
Docker VMs=Docker + VMs
Docker volume info=Información del Volumen de Docker
Docker will be available after Array is Started=
Docker=Docker
Download Windows VirtIO driver ISO=Descargar ISO de controladores VirtIO para Windows
Downloading=
Downstream=Sentido descendente
Drag-n-drop a PNG file or click the image at the left=Arrastre y suelte un archivo PNG o pulse en la imagen a la izquierda
Dumb=Dumb
Duplicate port entered=
Dynamix color theme=Color del tema de Dynamix
eg=e.g.
Email recipients=Direcciones email de los destinatarios
Email subject prefix=Prefijo para el asunto del email
Email=Email
enable advanced settings view=
Enable auto start=Habilitar inicio automático
Enable bonding=Habilitar unión de interfaces
Enable bridging=Habilitar puente de red
Enable disk shares=Habilitar discos compartidos
Enable Docker=Habilitar Docker
Enable NetBIOS=Habilitar NetBIOS
Enable NFS=Habilitar NFS
Enable SMB=Habilitar SMB
Enable SMB Multi Channel=
Enable spinup groups=Habilitar grupos de activación de discos
Enable user shares=Habilitar carpetas compartidas
Enable VLANs=Habilitar VLANs
Enable VMs=Habilitar máquinas virtuales
Enable WSD=Habilitar WSD
encrypted=
Enhanced macOS interoperability=Interoperatividad con macOS mejorada
ensure the peer network is different from=
ensure the peer networks are different from=
Enter route + gateway + metric=Introduzca ruta + puerta de enlace + métrica
Ether=Ethernet
Ethernet Port=Puerto Ethernet
Event=Evento
Every 2 hours=
Every 3 hours=
Every 4 hours=
Every 6 hours=
Every 8 hours=
Every day=Diariamente
Every hour=
Every month=Mensualmente
Every week=Semanalmente
exceeds Disk Shutdown=excede el Apagado del Disco
Excluded disks=Discos excluidos
Execution error=Error de ejecución
Fahrenheit=
Failed to open=
Failed to stop=No se pudo detener
Failure to do so may result in your docker image suffering corruption at a later time=Si ignora hacerlo su imagen de Docker podría corromperse en el futuro
First day=Primer día
First week=Primera semana
Flash backup=Copia de seguridad flash
Font size=Tamaño de fuente
Fourth week=Cuarta semana
FTP server=Servidor FTP
FTP Server=
FTP users=Usuario(s) FTP
Full Balance recommended=
gateway name or address=Nombre o dirección de la puerta de enlace
Gateway=Puerta de enlace
Generate Key=
Generate Keypair=
Global Share Settings=Recursos Compartidos
Global SMART Settings=Configuración Global de SMART
Header custom background color=Color de fondo personalizado del encabezado
Header custom meta text color=
Header custom secondary text color=
Header custom text color=Color de texto personalizado del encabezado
Header menu=Menú del encabezado
Header show description=
HHMM=HH:MM
Hibernate VMs=Hibernar VMs
Hide dot files=Ocultar archivos que comienzan con un con punto
Host access to custom networks=Acceso del host a redes personalizadas
hosts=hosts
Hourly=Cada hora
HTML color code of 3 or 6 hexadecimal digits=Código de color HTML de 3 o 6 dígitos hexadecimales
HTTP port=Puerto HTTP
HTTPS port=Puerto HTTPS
Huge=Enorme
Identification=Identificación
Import Tunnel=
Importance=Importancia
In most cases, this should be your public WAN IPv4 instead=
In most cases, this should be your public WAN IPv4=
In most cases, this should be your public WAN IPv6 instead=
In most cases, this should be your public WAN IPv6=
inactive=
Included disks=Discos incluidos
Interface description=Descripción de la interfaz
Interface Rules=Reglas de la interfaz
Invalid data=
Invalid email address=Dirección de email inválida
Invalid IPv4 gateway=Puerta de enlace IPv4 inválida
Invalid IPv4 range=Rango IPv4 inválido
Invalid IPv4 subnet=Subred IPv4 inválida
Invalid IPv6 gateway=Puerta de enlace IPv6 inválida
Invalid IPv6 range=Rango IPv6 inválido
Invalid IPv6 subnet=Subred IPv6 inválida
Invalid pool address=Espacio de direcciones inválido
Invalid subnet size=Tamaño de subred inválido
IP address or FQDN=
IPv4 address A.B.C.D=Dirección IPv4 A.B.C.D
IPv4 address assignment=Asignación de dirección IPv4
IPv4 address=Dirección IPv4
IPv4 custom network on interface=Red IPv4 personalizada de la interfaz
IPv4 default gateway=Puerta de enlace IPv4 predeterminada
IPv4 DNS server assignment=Asignación IPv4 del servidor DNS
IPv4 DNS server=Servidor DNS IPv4
IPv4 IPv6=IPv4 IPv6
IPv4 network=
IPv4 only=Solo IPv4
IPv4nn or IPv6nn route=Ruta IPv4/nn o IPv6/nn
IPv6 address assignment=Asignación de dirección IPv6
IPv6 address nnnnxxxxyyyy=Dirección IPv6 nnnn:xxxx::yyyy
IPv6 address=Dirección IPv6
IPv6 custom network on interface=Red IPv6 personalizada de la interfaz
IPv6 default gateway=Puerta de enlace IPv6 predeterminada
IPv6 DNS server assignment=Asignación IPv6 del servidor DNS
IPv6 DNS server=Servidor DNS IPv6
IPv6 network=
IPv6 only=Solo IPv6
IPv6 privacy extensions=Extensiones de privacidad IPv6
ipvlan=
is down=está desconectada
is not in the=
Isolated CPUs=CPUs aisladas
Isolation=Aislamiento
Join=
Key=Licencia
kyber=kyber
LAN hub spoke access=LAN hub & spoke access
LAN to LAN access=
Language update notification=Notificación de actualización de idioma
Language update=Actualización de idioma
Language=Idioma
Large=Grande
Last day=Ultimo día
Last handshake=
Last week=Ultima semana
LE Cert Provisioned successfully=Certificado Let's Encrypt aprovisionado con éxito
Leave=
Libvirt Log=Registro de libvirt
Libvirt storage location=Ruta del volumen de libvirt
Libvirt vdisk size=
Libvirt version=Versión de libvirt
Libvirt volume info=Información del Volumen de Libvirt
License key required=Licencia requerida
List of peers=
List of VLANs contains duplicate VLAN numbers=La lista de VLANs contiene números de VLAN duplicados
Listing height=Altura del listado
Loading=Cargando
Local endpoint=
Local gateway uses UPnP=
Local master=Maestro local
Local name=
Local private key=
Local public key=
Local server configuration=
Local server uses NAT=
Local syslog folder=Carpeta local del registro syslog
Local syslog maximum file size=Tamaño máximo del archivo local de registro syslog
Local syslog number of files=Número de archivos locales de registro syslog
Local syslog port=
Local syslog rotation=Rotación local de registro syslog
Local syslog server=Servidor local de registro syslog
Local TLD=TLD local
Local tunnel address IPv6=
Local tunnel address=
Local tunnel firewall=
Local tunnel network pool IPv6=
Local tunnel network pool=
Lost communication=Comunicación interrumpida
MAC address mismatch=
MAC address=Dirección MAC
macvlan=
Mail server port=Puerto del servidor de email
Mail server=Servidor de email
Manage password=
Manage=
Management Access=Ajustes de Acceso
mandatory=
Manual=Manual
member of=miembro de
Metric=Métrica
Mirror syslog to flash=Duplicar registro syslog en la memoria flash
Missing subnet size=Tamaño de subred no especificado
MM-DD-YYYY=MM-DD-AAAA
ModBus=ModBus
Modify with caution unable to validate path until Array is Started=Modify with caution: unable to validate path until Array is Started
Month of the year=Mes del año
Monthly=Mensual
Move now=Usar Mover
Mover is running=
Mover logging=Registro del servicio Mover
Mover schedule=Programación del servicio Mover
Mover Settings=Ajustes del Servicio Mover
mq-deadline=mq-deadline
MTU size=
Multi-function=Multifunción
Must be signed in to Unraidnet to provision cert=Must be signed in to Unraid.net to provision cert
name or ip address=
Net=Red
Network protocol=Protocolo de red
Network Services=Servicios de Red
Network Settings=Ajustes de Red
Never check=No comprobar nunca
Never send=No enviar nunca
New date and time=Fecha y hora manual
NFS=NFS
No Balance required=
No battery detected=Ninguna batería detectada
No Cache device present=
No Cache disk present=Ningún disco de Caché instalado
No change to report=
No CPU pinning available. Docker service must be started=Asignación de CPU no disponible. El servicio Docker debe estar iniciado
No CPU pinning available. VM service must be started=Asignación de CPU no disponible. El servicio de Máquinas Virtuales debe estar iniciado
no name=
No Parity disk present=Ningún disco de Paridad instalado
No Reply=
Nominal Power=Potencia Nominal
Non-tabbed=Sin pestañas
Not activated=No activado
Not allowed to assign ZERO cores=No se permite asignar CERO núcleos
Not compatible with NetBIOS=Incompatible con NetBIOS
not configured=sin configurar
Not present=
not received=
not set=sin estableber
Not up-to-date=No actualizado
not used=
Nothing to do=Nada que hacer
Notices=Avisos
Notification Agents=Servicios de Notificación
Notification entity=Selección de notificaciones
Notification Settings=Ajustes de Notificación
Notifications display=Modo de notificación
NTP server=Servidor NTP
Number format=Formato de número
Number scaling=Unidades de medida de almacenamiento
Obtaining DNSv4 server=Obteniendo servidor DNSv4
Obtaining DNSv6 server=Obteniendo servidor DNSv6
Obtaining IPv4 address=Obteniendo dirección IPv4
Obtaining IPv4 gateway=Obteniendo puerta de enlace IPv4
Obtaining IPv6 address=Obteniendo dirección IPv6
Obtaining IPv6 gateway=Obteniendo puerta de enlace IPv6
obtaining=obteniendo
On battery=Batería en uso
One or more paths do not exist=Una o más rutas no existen
Online boost=En línea (modo boost)
Online trim=En línea (modo trim)
Online=En línea
Only alphanumeric characters=Solo caracteres alfanuméricos
Only PNG images are allowed=Solo las imágenes PNG están permitidas
Oops=Uy
optional metric lowest is preferred, 0 is no default gateway=métrica opcional (la más baja es preferida, 0 no es una puerta de enlace predeterminada)
optional metric lowest is preferred=optional metric (lowest is preferred)
or=
Page view=Vista de página
Parity Check=Comprobación de Paridad
Password=Contraseña
Path does not exist=La ruta no existe
PCIe ACS override=Anulación de ACS PCIe
PCnet=PCnet
Peer allowed IPs=
Peer DNS server=
Peer endpoint=
Peer name=
Peer preshared key=
Peer private key=
Peer public key=
Peer tunnel address IPv6=
Peer tunnel address=
Peer type of access=
Peer update required=
Persistent keepalive=
Ping=
Placement of Users menu=Ubicación del menú de Usuarios
Please consider re-applying all configurations=
Please disable the VM function=Por favor, deshabilite el servicio de Máquinas Virtuales
Please do this NOW=Por favor, haga esto AHORA
Please enter a valid gateway=Por favor, introduzca una puerta de enlace válida
Please enter a valid range=Por favor, introduzca un rango válido
Please enter a valid sending email address=Por favor, introduzca una dirección de email de remitente válida
Please enter a valid subnet=Por favor, introduzca una subred válida
Please note that the flash backup is not encrypted at this time=Tenga en cuenta que la copia de seguridad flash no está cifrada en este momento.
Please Reboot system to make new rules active=Please **Reboot** system to make new rules active
Plugins update notification=Notificación de actualización de plugins
Plugins update=Actualización de plugins
Pool address is out of range=Espacio de direcciones fuera de rango
Pool subnet size is not defined=Tamaño del espacio de subred no definido
Pool subnet size is too large=Tamaño del espacio de subred demasiado grande
Port %s is already in use by other services=
Port %s is duplicated=
Port %s is out of range minimum 1 maximum 65535=Port %s is out of range (minimum 1 maximum 65535)
Port already in use=
Port Down=Puerto Desconectado
Port out of range=
Port Up=Puerto Conectado
Preserve user defined networks=Preservar redes creadas de usuario
Preset service=Servicio preconfigurado
Priority in header=Enviar con importancia alta
Protocol=Protocolo
Provision=Aprovisionar
QEMU version=
readmodifywrite=leer/modificar/escribir
recommended=
reconstruct write=reconstruir escritura
Refreshing=Recargando
Registration key required=Licencia requerida
Reinitialize=Reinicializar
Reinitializing=Reinicializando
Remark configure your router with port forwarding of port=Observación: configure su enrutador con el reenvío de puertos del puerto
Remark=
Remote access to LAN=
Remote access to server=
Remote peer configuration=
Remote syslog port=
Remote syslog server=Servidor de registro syslog remoto
Remote tunneled access=
Remove Windows VirtIO driver ISO=Eliminar ISO de controladores VirtIO para Windows
Replied=
resolution=resolución
Restore default image=
Route=Ruta
Routing Table=Tabla de Enrutamiento
Rule=
Rules contain duplicate MAC address assignments=
Rules=Reglas
Runtime left to initiate shutdown=Tiempo de batería restante para iniciar apagado
Runtime Left=Tiempo Restante
Samba extra configuration=Configuración adicional de Samba
Scheduled parity check=Programación para comprobar la paridad
Scheduler=Tareas Programadas
Scrub=Depurar
Scrub schedule=
Second week=Segunda semana
See Help for more details and workarounds=Mire la Ayuda para obtener más detalles y soluciones
see interface=ver interfaz
Send crash information to Unraid developers=
Send every hour=Enviar cada hora
Send every two hours=Enviar cada dos horas
Send four times a day=Enviar cuatro veces al día
Send once a day=Enviar una vez al día
Send once a month=Enviar una vez al mes
Send once a week=Enviar una vez a la semana
Send three times a day=Enviar tres veces al día
Send twice a day=Enviar dos veces al día
Sending email address=Dirección email del remitente
Server hub spoke access=Server hub & spoke access
Server name=Nombre del servidor
Server to server access=
Server was unable to provision SSL certificate=El servidor no fue capaz de aprovisionar un certificado SSL
Set password=
Setting disabled in safe mode=Ajuste deshabilitado en **modo seguro**
Settings menu=Menú de ajustes
Show array utilization indicator=Mostrar indicador de uso del array
Show banner=Mostrar banner
Show banner background color fade=
Show Dashboard apps=Aplicaciones a mostrar en el panel de Administración
Show Peer Config=
Shutdown time-out=Tiempo de espera para apagado
Shutdown VMs=Apagar VMs
shutdown=
Sign In to Unraidnet required=Sign In to Unraid.net required
Simple=Simple
Small=Pequeño
Smart=Smart
SMB Extras=Extras de SMB
SMB Settings=Ajustes de SMB
SMB=SMB
SMTP Settings=Ajustes de SMTP
SNMP=SNMP
Sorry, an error occurred in processing your SSL certificate=Ha ocurrido un error mientras se procesaba su certificado SSL, disculpe las molestias
Sorry, an error occurred updating unraidnet DNS records=Ha ocurrido un error mientras se actualizaban los registros DNS en unraidnet, disculpe las molestias
SSH port=Puerto SSH
Start APC UPS daemon=Iniciar servicio SAI APC
Start page=Página de inicio
Static=Estática
Stop %s to make changes, see=Detenga %s para realizar cambios, consulte
Stop corresponding docker containers=
Store notifications to flash=Guardar notificaciones en el dispositivo flash USB
Subject=Asunto
Subnet=Subred
subnet=
success=éxito
Summarized=Resumida
Syslog Server=Servidor Syslog
System notifications=Notificaciones del sistema
System Setting=Ajuste del Sistema
System Settings=Ajustes del Sistema
Tabbed=Con pestañas
TCP=
TELNET port=Puerto TELNET
Temperature unit=Unidad de temperatura
Template Authoring Mode=Modo de creación de plantillas
Terminal font size=
Test running=Prueba en ejecución
Test=
Text - Bar color=Texto - Barra (color)
Text - Bar gray=Texto - Barra (gris)
Text=Texto
The Local endpoint does not resolve to an IPv4 address=
The Local endpoint does not resolve to an IPv6 address=
The Local endpoint resolves to=
The Local tunnel network pool cannot be in=
The Local tunnel network pool IPv6 cannot be in=
Third week=Tercera semana
This is required to create VMs in KVM=Esto es requerido para crear máquinas virtuales en KVM
this mode requires a network switch with proper setup and support=este modo requiere un switch de red con soporte y ajuste adecuados
this must be the only peer in the tunnel and sole active tunnel when in use=
This removes any connections running over this tunnel=
This Unraid Server was unreachable from the outside=Este servidor de Unraid era inalcanzable desde el exterior
Time format=Formato de hora
Time of the day=Hora del día
Time on battery before shutdown=Tiempo en batería hasta iniciar apagado
Time zone=Zona horaria
time-out=fuera de tiempo
Timestamp=Marca de tiempo
TLS certificate location=Ubicación del certificado TLS
to=al
Toggle keys=
Toggle thread to containers=Asignar hilo a contenedores
Toggle view=
top-left=superior-izquierda
top-right=superior-derecha
Tunable enable Direct IO=Ajuste (habilitar Direct IO)
Tunable enable NCQ=Ajuste (habilitar NCQ)
Tunable fuse_remember=Parámetro (fuse_remember)
Tunable md_num_stripes=Tunable (md_num_stripes)
Tunable md_queue_limit=Parámetro(md_queue_limit)
Tunable md_sync_limit=Parámetro (md_sync_limit)
Tunable md_write_method=Ajuste (md_write_method)
Tunable nr_requests=Parámetro (nr_requests)
Tunable poll_attributes=Parámetro (poll_attributes)
Tunable scheduler=Ajuste (scheduler)
Tunable support Hard Links=Ajuste (soportar Hard Links)
Tunnel has running containers attached=
tunnel is inactive=
Turn off UPS after shutdown=Apagar el SAI tras apagar el sistema
UDP=
Unable to register this Unraid Server=No se puede registrar este servidor Unraid
; Keep the original plugin name in settings
Unassigned Devices=Unassigned Devices
Unraid OS update notification=Notificación de actualización de Unraid OS
Unraid OS update=Actualización de Unraid OS
Unraidnet account status=Unraid.net account status
Unraidnet Status=Estado de Unraid.net
Update DNS=Actualizar DNS
updating=actualizando
Updating=Actualizando
Upgrade Cert=
UPnP forwarding not set=UPnP: forwarding not set
UPnP state changed to=
UPnP tunnel is inactive=UPnP: tunnel is inactive
Upon host shutdown=Acción al apagar el sistema (host)
UPS cable=Cable del SAI
UPS Details=Detalles del SAI
UPS Load=Potencia en Uso
UPS Settings=Ajustes del SAI
UPS Status=Estado del SAI
UPS type=Tipo de SAI
USB=USB
Use image name dockerimg or docker-xfsimg or select a folder=Use image name docker.img or docker-xfs.img or select a folder
Use NTP=Usar NTP
Use only letters A-Z, digits or space,dash,underscore=
Use SSH=Usar SSH
Use SSLTLS=Usar SSL/TLS
Use STARTTLS=Usar STARTTLS
Use TELNET=Usar TELNET
Use UPnP=Usar UPnP
Used Free columns=Columnas espacio Usado / Disponible
User Preferences=Preferencias de Usuario
User root=User 'root'
User shares not enabled=Carpetas compartidas no habilitadas
User Utilities=Utilidades de Usuario
Username=Nombre de usuario
user-set=definido-por-usuario
value must be a number=el valor debe ser un número
Value=Valor
Very large=Muy grande
Very small=Muy pequeño
VFIO allow unsafe interrupts=VFIO permitir interrupciones no seguras
View libvirt log=Ver registro de libvirt
View Local Config=
View Peer Config=
view=ver
VLAN assignment mismatch=La asignación VLAN no concuerda
VLAN number=Número de VLAN
VM Manager=Máquinas Virtuales
VM manager=
VM Settings A reboot is required to apply changes=VM Settings: A reboot is required to apply changes
VM shutdown time-out=Tiempo de espera para apagar las VMs
VM=VM
VMs only=Solo VMs
VMs will be available after Array is Started=Las VMs estarán disponibles tras iniciar el Array
VPN Manager=Ajustes de VPN
VPN tunnel for docker containers only=
VPN tunneled access=
VPN tunneled access for docker=
VPN tunneled access for system=
WAN Port=Puerto WAN
Warnings=Advertencias
Watts=Vatios
Week of the month=Semana del mes
Weekly=Semanal
WireGuard Configuration=
Workgroup Settings=Ajustes de Grupo de Trabajo
Workgroup=Grupo de Trabajo
Write corrections to parity disk=Escribir correcciones al disco de paridad
WSD options experimental=Opciones de WSD [experimental]
xfs vDisk=
Yearly=Anual
You must be signed in to Unraidnet in order to generate an Unraidnet SSL certificate=You must be signed in to Unraid.net in order to generate an Unraid.net SSL certificate
Your existing Docker image file needs to be recreated due to an issue from an earlier beta of Unraid 6=Su archivo de imagen de Docker debe ser recreado debido a un problema con una versión beta previa de Unraid 6
Your hardware does not have Intel VT-x or AMD-V capability=Su hardware no soporta la tecnología de virtualización Intel VT-x o AMD-V
Your Lets Encrypt SSL Certificate has been provisioned and a DNS record for local IP address=Su certificado SSL de Let's Encrypt ha sido aprovisionado y un registro DNS para la dirección IP local
Your Lets Encrypt SSL Certificate has been renewed=Su certificado SSL de Let's Encrypt ha sido renovado
Your local IP address %s has been updated for unraidnet=Your local IP address %s has been updated for unraid.net
Your router or DNS server has DNS rebinding protection enabled, preventing=Su router o servidor DNS tiene activada la protección contra revinculación de DNS, evitando
Your server has been registered=Su servidor ha sido registrado
Your Unraid Server is reachable from the internet=Su servidor Unraid es accesible desde Internet
YYYY-MM-DD=AAAA-MM-DD

; My Servers plugin
Are you sure you want pause communication with your remote flash backup on unraidnet=Are you sure you want pause communication with your remote flash backup on unraid.net?
Are you sure you want to erase all change history in both local and unraidnet remote=Are you sure you want to erase all change history in both local and unraid.net remote?
Disabled until you Provision an unraidnet SSL Cert and set SSL-TLS to Auto=Disabled until you Provision an unraid.net SSL Cert and set SSL-TLS to Auto
Disabled until you Provision an unraidnet SSL Cert=Disabled until you Provision an unraid.net SSL Cert
Disabled until your root user account is password-protected=
Enable Transparent 2FA for Local Access=
Enable Transparent 2FA for Remote Access=
In order to activate Flash Backup there must be at least 1GB of free space on your flash drive=In order to activate Flash Backup there must be at least 1GB of free space on your flash drive.
Local T2FA requires a myunraidnet certificate=Local T2FA requires a *.myunraid.net certificate
Local T2FA requires Unraid 610 or higher and a myunraidnet certificate=Local T2FA requires Unraid 6.10 or higher and a *.myunraid.net certificate
Local T2FA requires Unraid 610 or higher=Local T2FA requires Unraid 6.10 or higher
Local T2FA requires Use SSLTLS to be Auto and a myunraidnet certificate=Local T2FA requires Use SSL/TLS to be Auto and a *.myunraid.net certificate
Local T2FA requires Use SSLTLS to be Auto and Unraid 610 or higher=Local T2FA requires Use SSL/TLS to be Auto and Unraid 6.10 or higher
Local T2FA requires Use SSLTLS to be Auto, Unraid 610 or higher, and a myunraidnet certificate=Local T2FA requires Use SSL/TLS to be Auto, Unraid 6.10 or higher, and a *.myunraid.net certificate
Local T2FA requires Use SSLTLS to be Auto=Local T2FA requires Use SSL/TLS to be Auto
More information=More information.
port=
Remote T2FA requires a myunraidnet certificate=Remote T2FA requires a *.myunraid.net certificate
Remote T2FA requires Remote Access to be enabled and a myunraidnet certificate=Remote T2FA requires Remote Access to be enabled and a *.myunraid.net certificate
Remote T2FA requires Remote Access to be enabled and Unraid 610 or higher=Remote T2FA requires Remote Access to be enabled and Unraid 6.10 or higher
Remote T2FA requires Remote Access to be enabled, Unraid 610 or higher, and a myunraidnet certificate=Remote T2FA requires Remote Access to be enabled, Unraid 6.10 or higher, and a *.myunraid.net certificate
Remote T2FA requires Remote Access to be enabled=
Remote T2FA requires Unraid 610 or higher and a myunraidnet certificate=Remote T2FA requires Unraid 6.10 or higher and a *.myunraid.net certificate
Remote T2FA requires Unraid 610 or higher=Remote T2FA requires Unraid 6.10 or higher
The Unraid server is unreachable from outside your network Be sure you have configured your router to forward port=The Unraid server is unreachable from outside your network. Be sure you have configured your router to forward port
to the Unraid server at=
Transient errors in this log can be ignored unless you are having issues=
Unraid API extra origins=
View Flash Backup Error Log=

; Note: May 20, 2022 - 193 missing translations
